
20 20
60
150
10 12
####################
#--#---------------#
#--#---------------#
#------------------#
#------------------#
#------------------#
#------------------#
#------------------#
#------------------#
#------------------#
#------------------#
#------------------#
#------------------#
#------------------#
#------------------#
#------------------#
#------------------#
#------------------#
#------------------#
####################